WWWWWWWWWWWWWWW
W             W
W         D   W
W    W        W
W          WW W
W             W
W     FP      W
W             W
W          M  W
W             W
W  E  *       W
W          WW W
W  *  *       W
W             W
WWWWWWWWWWWWWWW