WWWWWWWWWWWWWWW
W             W
W             W
W    W        W
W          WW W
W     DR      W
W     FP      W
W    K        W
W          M  W
W             W
W  E   *      W
W          WW W
W       *     W
W   *         W
WWWWWWWWWWWWWWW