WWWWWWWWWWWWWWW
W             W
W             W
W    W        W
W          WW W
W             W
W      P      W
W             W
W             W
W             W
W  E  *       W
W          WW W
W  *  *       W
W             W
WWWWWWWWWWWWWWW